BBBBBBBBBBBBBB
BB          BB
B            B
BB          BB
B            B
BB          BB
B            B
BB          BB
B            B
BB    ++    BB
B            B
BB          BB
BB          BB
B            B
BB          BB
B            B
BB          BB
B            B
B ++  ++  ++ B
