BBBBBBBBBBBBBB
BB          BB
B            B
BB          BB
B            B
BB          BB
B            B
BB          BB
B     ++     B
BB          BB
B            B
BB          BB
B            B
BB          BB
B            B
BB          BB
B ++  ++  ++ B
